6 64 14 7 98 48 0 1 2 1 1 2 2 2 2 2 2 2 2 2 2 2 2 2 2 2 2 2 1 1 2 2 2 2 2 2 1 2 2 1 2 2 2 2 2 2 2 2 2 2 2 2 2 2 2 2 2 2 2 2 2 2 2 2 2 2 2 2 2 2 
3 4 5 6 7 8 9 9 10 11 9 12 9 12 10 11 9 9 10 11 9 9 4 7 8 10 11 9 10 11 4 5 13 6 5 14 9 10 11 9 9 10 11 9 9 9 15 16 9 9 9 9 12 17 9 10 11 12 9 17 9 9 10 11 
18 19 20 21 21 22 23 24 25 26 27 28 26 28 29 9 9 23 9 30 9 9 19 21 22 9 31 32 32 33 19 20 20 21 20 22 23 9 34 9 31 32 33 23 9 34 35 36 37 38 25 26 28 39 40 27 26 28 29 37 41 9 9 30 
42 43 44 45 45 46 47 48 49 49 49 50 49 50 51 52 53 54 55 56 57 58 43 45 46 59 60 61 61 62 43 44 44 45 44 46 47 53 63 64 60 61 62 64 59 63 65 66 47 48 49 49 50 49 50 49 49 50 51 53 54 55 57 56 
67 68 68 68 68 68 68 68 68 68 68 68 68 68 68 68 69 70 71 70 71 70 71 70 71 72 73 74 74 75 70 70 76 77 70 78 68 68 79 68 80 81 82 69 72 83 73 75 70 70 84 70 84 70 84 70 78 68 68 68 68 68 68 68 
85 86 86 86 86 86 86 86 86 86 86 86 86 86 86 86 87 88 89 88 89 88 89 88 89 90 91 92 92 93 88 88 94 95 88 96 86 86 86 86 86 86 86 87 90 90 91 93 88 88 97 88 97 88 97 88 96 86 86 86 86 86 86 86 
