18
1 21 1 0 362 100 70 0 0 0
2 21 1 100 362 200 70 0 0 0
3 21 1 200 362 100 70 0 0 0
4 21 1 300 362 100 70 0 0 0
5 21 1 400 362 100 70 0 0 0
6 21 1 500 362 62 70 0 0 0
7 21 1 562 303 100 127 0 0 0
8 21 1 662 303 100 127 0 0 0
9 21 1 762 303 100 127 0 0 0
10 21 1 862 303 50 127 0 0 0
11 21 1 912 245 100 186 0 0 0
12 21 1 1012 245 100 186 0 0 0
13 21 1 1112 245 100 186 0 0 0
14 21 1 1212 245 50 186 0 0 0
15 21 1 1262 187 100 245 0 0 0
16 21 1 1362 187 100 245 0 0 0
17 21 1 1462 187 100 245 0 0 0
18 21 1 1562 187 44 245 0 0 0
10 21 1 288 362 32 70 0 0 0
11 21 1 320 362 26 70 0 0 0
12 21 1 346 303 32 127 0 0 0
13 21 1 378 303 32 127 0 0 0
14 21 1 410 303 32 127 0 0 0
15 21 1 442 303 32 127 0 0 0
16 21 1 474 303 32 127 0 0 0
17 21 1 506 303 32 127 0 0 0
18 21 1 538 303 17 127 0 0 0
19 21 1 555 245 32 186 0 0 0
20 21 1 587 245 32 186 0 0 0
21 21 1 619 245 32 186 0 0 0
22 21 1 651 245 32 186 0 0 0
23 21 1 683 245 32 186 0 0 0
24 21 1 715 245 32 186 0 0 0
25 21 1 747 245 28 186 0 0 0
26 21 1 775 187 32 245 0 0 0
27 21 1 807 187 32 245 0 0 0
28 21 1 839 187 32 245 0 0 0
29 21 1 871 187 32 245 0 0 0
30 21 1 903 187 32 245 0 0 0
31 21 1 935 187 44 245 0 0 0
32 21 1 1067 362 40 70 0 0 0
33 21 1 1153 303 40 127 0 0 0
34 21 1 1237 245 40 186 0 0 0
35 21 1 1279 362 32 70 0 0 0
36 21 1 1311 362 32 70 0 0 0
37 21 1 1343 362 32 70 0 0 0
38 21 1 1375 362 32 70 0 0 0
39 21 1 1407 362 32 70 0 0 0
40 21 1 1439 362 18 70 0 0 0
41 21 1 1457 187 32 245 0 0 0
42 21 1 1537 362 126 70 0 0 0
43 21 1 1621 187 126 70 0 0 0
44 21 1 1710 303 81 127 0 0 0
45 21 1 1749 245 388 18 0 0 0
46 21 1 1839 362 81 70 0 0 0
47 21 1 1969 303 81 127 0 0 0
48 21 1 2096 362 162 70 0 0 0
49 21 1 2139 187 235 105 0 0 0
50 21 1 2432 362 42 70 0 0 0
51 21 1 2527 187 75 245 0 0 0
52 21 1 2646 303 40 127 0 0 0
53 21 1 2731 303 131 127 0 0 0
54 21 1 2862 245 122 185 0 0 0
55 21 1 2987 362 190 70 0 0 0
56 21 1 3177 303 23 127 0 0 0
57 21 1 3200 362 190 70 0 0 0
58 21 1 3330 303 125 127 0 0 0
59 21 1 3455 362 88 70 0 0 0
60 21 1 3545 303 88 127 0 0 0
61 21 1 3630 245 209 186 0 0 0
62 21 1 3926 362 149 70 0 0 0
63 21 1 1488 187 89 78 0 0 0
64 111 1 1450 187 10 150 0 0 0
