271
1 21 1 0 362 32 70 0 0 0
2 21 1 32 362 32 70 0 0 0
3 21 1 64 362 32 70 0 0 0
4 21 1 96 362 32 70 0 0 0
5 21 1 128 362 32 70 0 0 0
6 21 1 160 362 32 70 0 0 0
7 21 1 192 362 32 70 0 0 0
8 21 1 224 362 32 70 0 0 0
9 21 1 256 362 32 70 0 0 0
10 21 1 288 362 32 70 0 0 0
11 21 1 320 362 32 70 0 0 0
12 21 1 352 362 32 70 0 0 0
13 21 1 384 362 32 70 0 0 0
14 21 1 416 362 32 70 0 0 0
15 21 1 448 362 32 70 0 0 0
16 21 1 480 362 32 70 0 0 0
17 21 1 512 362 32 70 0 0 0
18 21 1 544 362 17 70 0 0 0
19 21 1 561 303 32 127 0 0 0
20 21 1 593 303 32 127 0 0 0
21 21 1 625 303 32 127 0 0 0
22 21 1 657 303 32 127 0 0 0
23 21 1 689 303 32 127 0 0 0
24 21 1 721 303 32 127 0 0 0
25 21 1 753 303 32 127 0 0 0
26 21 1 785 303 32 127 0 0 0
27 21 1 817 303 32 127 0 0 0
28 21 1 849 303 32 127 0 0 0
29 21 1 881 303 30 127 0 0 0
30 21 1 911 245 32 186 0 0 0
31 21 1 943 245 32 186 0 0 0
32 21 1 975 245 32 186 0 0 0
33 21 1 1007 245 32 186 0 0 0
34 21 1 1039 245 32 186 0 0 0
35 21 1 1071 245 32 186 0 0 0
36 21 1 1103 245 32 186 0 0 0
37 21 1 1135 245 32 186 0 0 0
38 21 1 1167 245 32 186 0 0 0
39 21 1 1199 245 32 186 0 0 0
40 21 1 1231 245 30 186 0 0 0
41 21 1 1261 187 32 245 0 0 0
42 21 1 1293 187 32 245 0 0 0
43 21 1 1325 187 32 245 0 0 0
44 21 1 1357 187 32 245 0 0 0
45 21 1 1389 187 32 245 0 0 0
46 21 1 1421 187 32 245 0 0 0
47 21 1 1453 187 32 245 0 0 0
48 21 1 1485 187 32 245 0 0 0
49 21 1 1517 187 32 245 0 0 0
50 21 1 1549 187 32 245 0 0 0
51 111 1 1581 187 27 245 0 0 1
52 111 1 1752 362 68 70 0 0 1
53 111 1 1892 303 68 127 0 0 1
54 111 1 2031 245 68 186 0 0 1
55 21 1 2099 362 32 70 0 0 0
56 21 1 2131 362 32 70 0 0 0
57 21 1 2163 362 32 70 0 0 0
58 21 1 2195 362 32 70 0 0 0
59 21 1 2227 362 32 70 0 0 0
60 21 1 2259 362 32 70 0 0 0
61 21 1 2291 362 32 70 0 0 0
62 21 1 2323 362 32 70 0 0 0
63 21 1 2355 362 32 70 0 0 0
64 21 1 2387 362 10 70 0 0 0
65 21 1 2397 187 32 245 0 0 0
66 21 1 2429 187 32 105 0 0 0
67 21 1 2461 187 32 97 0 0 0
68 21 1 2493 187 32 97 0 0 0
69 21 1 2525 187 32 97 0 0 0
70 111 1 2557 187 32 97 0 0 1
71 111 1 2390 195 6 245 0 0 0
72 21 1 2308 245 32 10 0 0 0
73 21 1 2340 245 32 10 0 0 0
74 21 1 2372 245 7 10 0 0 0
75 21 1 2528 362 32 35 0 0 0
76 21 1 2560 362 32 35 0 0 0
77 21 1 2592 362 32 35 0 0 0
78 21 1 2624 362 32 35 0 0 0
79 21 1 2656 362 32 35 0 0 0
80 21 1 2688 362 32 35 0 0 0
81 21 1 2720 362 8 35 0 0 0
82 111 1 2659 187 32 97 0 0 1
83 21 1 2691 187 32 10 0 0 0
84 21 1 2723 187 32 10 0 0 0
85 21 1 2755 187 32 10 0 0 0
86 21 1 2787 187 32 10 0 0 0
87 21 1 2819 187 32 10 0 0 0
88 21 1 2851 187 18 50 0 0 0
89 21 1 2810 303 32 35 0 0 0
90 21 1 2842 303 32 35 0 0 0
91 21 1 2874 303 32 35 0 0 0
92 21 1 2906 303 32 35 0 0 0
93 21 1 2869 235 32 10 0 0 0
94 21 1 2901 235 32 10 0 0 0
95 21 1 2933 235 32 10 0 0 0
96 21 1 2965 235 32 10 0 0 0
97 21 1 2997 235 32 10 0 0 0
98 21 1 3029 235 32 10 0 0 0
99 21 1 3061 235 32 10 0 0 0
100 21 1 3093 235 32 10 0 0 0
101 21 1 3125 235 32 10 0 0 0
102 21 1 3157 235 32 10 0 0 0
103 21 1 3189 235 32 10 0 0 0
104 21 1 3221 235 32 10 0 0 0
105 21 1 3253 235 32 10 0 0 0
106 21 1 3285 235 32 10 0 0 0
107 21 1 3317 235 32 10 0 0 0
108 21 1 3349 235 32 10 0 0 0
109 21 1 3381 235 32 10 0 0 0
110 21 1 3413 235 32 10 0 0 0
111 21 1 3445 235 32 10 0 0 0
112 21 1 3477 235 32 10 0 0 0
113 21 1 3008 362 44 35 0 0 0
114 21 1 3052 362 32 35 0 0 0
115 21 1 3084 362 32 35 0 0 0
116 21 1 3116 362 32 35 0 0 0
117 21 1 3230 310 32 35 0 0 0
118 21 1 3262 310 32 35 0 0 0
119 21 1 3294 310 32 35 0 0 0
120 21 1 3326 310 32 35 0 0 0
121 21 1 3431 362 11 35 0 0 0
122 21 1 3442 362 21 35 0 0 0
123 21 1 3463 362 32 35 0 0 0
124 21 1 3495 362 32 35 0 0 0
125 21 1 3527 362 32 35 0 0 0
126 21 1 3559 362 32 35 0 0 0
127 21 1 3591 362 32 35 0 0 0
128 21 1 3623 362 32 35 0 0 0
129 21 1 3655 362 32 35 0 0 0
130 21 1 3687 362 20 35 0 0 0
131 21 1 3504 187 32 45 0 0 0
132 21 1 3536 187 32 45 0 0 0
133 21 1 3568 187 32 45 0 0 0
134 21 1 3600 187 32 45 0 0 0
135 21 1 3632 187 32 45 0 0 0
136 21 1 3664 187 32 45 0 0 0
137 21 1 3696 187 32 45 0 0 0
138 21 1 3728 187 32 45 0 0 0
139 21 1 3760 187 32 45 0 0 0
140 21 1 3792 187 32 45 0 0 0
141 111 1 3824 187 26 45 0 0 2
142 111 1 3990 362 32 70 0 0 1
143 111 1 4022 362 32 70 0 0 1
144 21 1 4050 362 5 70 0 0 0
145 21 1 4060 245 32 10 0 0 0 
146 21 1 4092 245 32 10 0 0 0 
147 21 1 4124 245 4 10 0 0 0
148 111 1 4140 190 10 245 0 0 0
149 21 1 4147 187 15 245 0 0 0
150 21 1 4162 187 32 245 0 0 0
151 21 1 4194 187 32 245 0 0 0
152 21 1 4226 187 32 245 0 0 0
153 111 1 4258 187 10 245 0 0 1
154 111 1 4340 303 32 127 0 0 1
155 21 1 4372 303 32 127 0 0 0
156 111 1 4404 303 3 127 0 0 1
157 111 1 4480 303 32 127 0 0 1
158 21 1 4512 303 32 127 0 0 0
159 21 1 4544 303 32 127 0 0 0
160 21 1 4576 303 32 127 0 0 0
161 21 1 4608 303 32 127 0 0 0
162 21 1 4640 303 32 127 0 0 0
163 21 1 4672 303 32 127 0 0 0
164 21 1 4690 303 18 127 0 0 0
165 21 1 4708 245 14 186 0 0 0
166 21 1 4722 245 32 186 0 0 0
167 21 1 4754 245 32 186 0 0 0
168 21 1 4786 245 32 186 0 0 0
169 21 1 4818 245 32 186 0 0 0
170 21 1 4850 245 32 186 0 0 0
171 111 1 4882 245 16 186 0 0 1
172 21 1 4899 362 32 70 0 0 0
173 21 1 4931 362 32 70 0 0 0
174 21 1 4963 362 32 70 0 0 0
175 21 1 4995 362 32 70 0 0 0
176 21 1 5027 362 32 70 0 0 0
177 21 1 5059 362 32 70 0 0 0
178 21 1 5091 362 17 70 0 0 0
179 21 1 5108 303 32 127 0 0 0
180 21 1 5140 303 32 127 0 0 0
181 21 1 5172 303 32 127 0 0 0
182 21 1 5204 303 32 127 0 0 0
183 21 1 5236 303 10 127 0 0 0
184 21 1 5246 362 32 70 0 0 0
185 21 1 5278 362 32 70 0 0 0
186 21 1 5310 362 32 70 0 0 0
187 21 1 5342 362 32 70 0 0 0
188 21 1 5374 362 32 70 0 0 0
189 21 1 5406 362 32 70 0 0 0
190 21 1 5438 362 21 70 0 0 0
191 21 1 5459 303 32 127 0 0 0
192 21 1 5491 303 32 127 0 0 0
193 21 1 5523 303 32 127 0 0 0
194 21 1 5555 303 32 127 0 0 0
195 21 1 5587 303 32 127 0 0 0
196 21 1 5619 303 32 127 0 0 0
197 21 1 5651 303 14 127 0 0 0
198 21 1 5665 362 32 70 0 0 0
199 21 1 5697 362 32 70 0 0 0
200 21 1 5729 362 32 70 0 0 0
201 21 1 5761 362 32 70 0 0 0
202 21 1 5793 362 16 70 0 0 0
203 21 1 5809 303 32 127 0 0 0
204 21 1 5841 303 32 127 0 0 0
205 21 1 5873 303 32 127 0 0 0
206 21 1 5905 303 32 127 0 0 0
207 21 1 5937 303 11 127 0 0 0
208 21 1 5948 245 32 186 0 0 0
209 21 1 5980 245 32 186 0 0 0
210 21 1 6012 245 32 186 0 0 0
211 21 1 6044 245 32 186 0 0 0
212 21 1 6076 245 32 186 0 0 0
213 21 1 6108 245 32 186 0 0 0
214 21 1 6140 245 32 186 0 0 0
215 21 1 6172 245 32 186 0 0 0
216 21 1 6204 245 32 186 0 0 0
217 21 1 6236 245 32 186 0 0 0
218 111 1 6268 245 30 186 0 0 1
219 21 1 6439 362 32 70 0 0 0
220 21 1 6471 362 32 70 0 0 0
221 21 1 6503 362 32 70 0 0 0
222 21 1 6535 362 32 70 0 0 0
223 21 1 6567 362 32 70 0 0 0
224 21 1 6599 362 32 70 0 0 0
225 21 1 6631 362 32 70 0 0 0
226 21 1 6663 362 32 70 0 0 0
227 21 1 6695 362 24 70 0 0 0
228 24 -1 755 204 0 0 0 221 2
229 15 -1 1121 180 0 0 0 0 1
230 111 1 2853 187 18 50 0 0 3
231 111 1 3839 187 10 50 0 0 2
232 16 1 3528 107 0 0 0 0 1
233 16 -1 3443 165 0 0 0 0 1
234 16 -1 3621 107 0 0 0 0 1
235 24 -1 755 204 0 0 0 230 2
236 24 -1 965 148 0 0 0 222 2
237 24 -1 1523 121 0 0 0 224 2
238 24 -1 2190 148 0 0 0 230 2
239 24 -1 2507 268 0 0 0 222 2
240 24 -1 3031 148 0 0 0 225 2
241 24 -1 3270 148 0 0 0 221 2
242 24 -1 3660 236 0 0 0 226 2
243 24 -1 3978 268 0 0 0 224 2
244 24 -1 4534  178 0 0 0 225 2
245 24 -1 4778 148 0 0 0 221 2
246 24 -1 5165 206 0 0 0 222 2
247 24 -1 5447 206 0 0 0 224 2
248 24 -1 5725  178 0 0 0 230 2
249 24 -1 6183 148 0 0 0 222 2
250 13 1 5966 137 0 0 0 0 1
251 12 -1 2300 280 0 0 2228 2349 1
252 12 -1 2527 100 0 0 2500 2549 1
253 11 -1 635 223 0 0 560 860 1
254 11 -1 843 223 0 0 560 860 1
255 11 -1 1902 220 0 0 1884 1909 1
256 11 -1 2526 286 0 0 2521 2679 1
257 11 -1 2667 282 0 0 2521 2679 1
258 11 -1 4138 107 0 0 4140 4218 1
259 11 -1 6478 223 0 0 6440 6628 1
260 10 -1 2000 80 0 0 0 0 1
261 10 -1 3143 107 0 0 0 0 1
262 10 1 3149 80 0 0 0 0 1
263 10  -1 5278 107 0 0 0 0 1
264 10 -1 5881 107 0 0 0 0 1
265 10 -1 6578 107 0 0 0 0 1
266 15 -1 1402 126 0 0 0 0 1
267 15 -1 3230 249 0 0 0 0 1
268 15 -1 4555 249 0 0 0 0 1
269 15 -1 4976 300 0 0 0 0 1
270 15 -1 5393 300 0 0 0 0 1
271 15 -1 5845 180 0 0 0 0 1