5
1 21 1 0 391 576 40 0 0 0
2 111 1 0 106 70 190 0 0 1
3 21 1 0 296 39 95 0 0 0
4 111 1 505 106 71 285 0 0 1
5 17 -1 406 202 0 0 0 0 2