135
1 21 1 0 365 32 32 0 0 0
2 21 1 32 365 32 32 0 0 0
3 21 1 64 365 32 32 0 0 0
4 21 1 96 365 32 32 0 0 0
5 21 1 128 365 32 32 0 0 0
6 21 1 160 365 32 32 0 0 0
7 21 1 192 365 32 32 0 0 0
8 21 1 224 365 32 32 0 0 0
9 21 1 256 365 32 32 0 0 0
10 21 1 288 365 32 32 0 0 0
11 21 1 320 365 32 32 0 0 0
12 21 1 352 365 32 32 0 0 0
13 21 1 384 365 32 32 0 0 0
14 21 1 416 365 32 32 0 0 0
15 21 1 448 365 32 32 0 0 0
16 21 1 480 365 32 32 0 0 0
17 21 1 512 365 32 32 0 0 0
18 21 1 544 365 32 32 0 0 0
19 21 1 576 365 32 32 0 0 0
20 21 1 608 365 32 32 0 0 0
21 21 1 640 365 32 32 0 0 0
22 21 1 672 365 32 32 0 0 0
23 21 1 704 365 32 32 0 0 0
24 21 1 736 365 32 32 0 0 0
25 21 1 768 365 32 32 0 0 0
26 21 1 800 365 32 32 0 0 0
27 21 1 832 365 32 32 0 0 0
28 21 1 864 365 32 32 0 0 0
29 21 1 896 365 32 32 0 0 0
30 21 1 928 365 32 32 0 0 0
31 21 1 960 365 32 32 0 0 0
32 21 1 992 365 32 32 0 0 0
33 21 1 1024 365 32 32 0 0 0
34 21 1 1056 365 32 32 0 0 0 
35 11 -1 505 280 0 0 1 1023 1
36 11 -1 605 280 0 0 0 1023 1
37 11 -1 700 280 0 0 0 1023 1
38 21 1 1159 365 54 32 0 0 0
39 21 1 1286 365 54 32 0 0 0
40 21 1 1415 365 54 32 0 0 0
41 21 1 1546 365 54 32 0 0 0 
42 21 1 1610 298 54 101 0 0 0
43 21 1 1674 238 32 161 0 0 0
44 21 1 1706 238 32 161 0 0 0
45 21 1 1738 238 32 161 0 0 0
46 21 1 1770 238 32 161 0 0 0
47 21 1 1802 238 32 161 0 0 0
48 21 1 1834 238 32 161 0 0 0
49 21 1 1866 238 32 161 0 0 0
50 21 1 1898 238 22 161 0 0 0
51 21 1 2057 365 32 32 0 0 0
52 21 1 2089 365 32 32 0 0 0
53 21 1 2121 365 32 32 0 0 0
54 21 1 2153 365 23 32 0 0 0
55 21 1 2251 365 32 32 0 0 0
56 21 1 2283 365 32 32 0 0 0
57 21 1 2315 365 32 32 0 0 0
58 21 1 2347 365 32 32 0 0 0
59 21 1 2379 365 32 32 0 0 0
60 21 1 2411 365 32 32 0 0 0
61 21 1 2443 365 32 32 0 0 0
62 21 1 2475 365 32 32 0 0 0
63 21 1 2507 365 32 32 0 0 0
64 21 1 2539 365 32 32 0 0 0
65 21 1 2571 365 32 32 0 0 0
66 21 1 2603 365 32 32 0 0 0
67 21 1 2635 365 32 32 0 0 0
68 21 1 2667 365 32 32 0 0 0
69 21 1 2699 365 32 32 0 0 0
70 21 1 2731 365 32 32 0 0 0
71 21 1 2763 365 32 32 0 0 0
72 21 1 2795 365 21 32 0 0 0
73 21 1 2438 238 54 32 0 0 0
74 21 1 2568 238 32 32 0 0 0
75 21 1 2600 238 32 32 0 0 0
76 21 1 2632 238 32 32 0 0 0
77 21 1 2664 238 32 32 0 0 0 
78 21 1 2696 238 32 32 0 0 0
79 21 1 2728 238 22 32 0 0 0
80 21 1 2824 298 54 101 0 0 0
81 21 1 2888 238 54 161 0 0 0
82 21 1 2951 183 32 230 0 0 0
83 21 1 2983 183 32 230 0 0 0
84 21 1 3015 183 32 230 0 0 0
85 21 1 3047 183 23 230 0 0 0
86 21 1 3210 365 23 32 0 0 0
87 21 1 3337 365 23 32 0 0 0
88 21 1 3463 365 23 32 0 0 0
89 21 1 3599 365 32 32 0 0 0
90 21 1 3631 365 32 32 0 0 0
91 21 1 3663 365 32 32 0 0 0
92 21 1 3695 365 32 32 0 0 0
93 21 1 3727 365 32 32 0 0 0
94 21 1 3759 365 32 32 0 0 0
95 21 1 3791 365 32 32 0 0 0
96 21 1 3823 365 32 32 0 0 0
97 21 1 3855 365 32 32 0 0 0
98 21 1 3887 365 32 32 0 0 0
99 21 1 3919 365 32 32 0 0 0
100 21 1 3951 365 32 32 0 0 0
101 21 1 3983 365 32 32 0 0 0
102 21 1 4015 365 32 32 0 0 0
103 21 1 4047 365 32 32 0 0 0
104 21 1 4079 365 17 32 0 0 0
105 11 -1 895 280 0 0 0 1023 1
106 11 -1 2585 165 0 0 2560 2720 1
107 11 -1 2896 165 0 0 2870 2900 1
108 11 -1 2968 110 0 0 2926 3039 1
109 11 -1 3770 280 0 0 3595 4036 1
110 11 -1 3926 280 0 0 3595 4036 1
111 23 -1 665 281 0 0 0 221 2
112 23 -1 858 281 0 0 0 221 2
113 23 -1 1147 281 0 0 0 222 2
114 23 -1 1271 254 0 0 0 228 2
115 23 -1 1530 227 0 0 0 227 2
116 23 -1 1785 165 0 0 0 225 2
117 23 -1 2303 281 0 0 0  222 2
118 23 -1 2364 165 0 0 0 226 2
119 23 -1 2651 165 0 0 0 222 2
120 23 -1 3324 281 0 0 0 229  2
121 23 -1 3706 281 0 0 0 224 2
122 13 1 462 333 0 0 0 1083 1
123 13 -1 1803 200 0 0 0 0 1
124 13 1 1874 200 0 0 0 0 1
125 13 -1 2530 330 0 0 0 0 1
126 10 -1 1108 140 0 0 0 0 1
127 10 -1 1428 140 0 0 0 0 1
128 10 1 2109 173 0 0 0 0 1
129 10 1 3130 173 0 0 0 0 1
130 10 -1 3444 140 0 0 0 0 1
131 10 -1 3735 140 0 0 0 0 1
132 12 -1 1628 200 0 0 1580 1630 1
133 12 -1 2409 140 0 0 2400 2465 1
134 14 -1 2742 304 0 0 2256 2775 1
135 111 1 3995 230 30 200 0 0 9
136 111 1 500 230 80 120 0 0 9